Are religious people just dumber, more susceptible, less curious. what? Disagree?:	undefined	undefined
Affirming Christians are the real bigots: Even as Sodom and Gomorrha, and the cities about them in like manner, giving themselves over to fornication, and going after strange flesh, are set forth for an example, suffering the vengeance of eternal fire. How can you tell people what they are doing is ok when God warned you that they will go hell?	anti-Christianity	explicit derogation
Atheists are deep frying aborted embryos.	anti-Atheism	explicit derogation
I hate Muslims: Muslims are all terrorists who only want to murder Jews	anti-Islam	explicit derogation
I hate Muslims	anti-Islam	explicit derogation
Jewwwws are liars	undefined	explicit derogation
How Christian of you	anti-Christianity	abusive humor
Religion was invented the day the first con man met the first fool:	undefined	implicit animosity
Atheists are deep frying aborted embryos for karma.	anti-Atheism	explicit derogation
Just another Satanist :)	undefined	abusive humor
No no no. im not religious. Those people are crazy. I'm a spiritualist.:	undefined	undefined
redneck satanist	undefined	abusive humor
Another average satanist	undefined	abusive humor
Christian keep people stupid	anti-Christianity	explicit derogation
Buzzed blue collar satanist	undefined	abusive humor
Women : are inferior human beings. So are the jews niggers and mexicans.	undefined	dehumanization
Atheism is just as dumb as Wicca	anti-Atheism	explicit derogation
Buddhism is all about Pedophilia	anti-Buddhism	explicit derogation
I hate Christians:	anti-Christianity	explicit derogation
christianâ€™s are a virus	anti-Christianity	dehumanization
Pacifists be like	undefined	undefined
fuck all catholics and fuck all swedes	anti-Christianity	explicit derogation
Fuck off atheists	anti-Atheism	explicit derogation
Eat shit satanist	undefined	explicit derogation
Kill yourself satanists,ðŸ«µ	undefined	threatening language
I wanted to tell a joke about Islam: But I blew up	anti-Islam	abusive humor
average atheist	anti-Atheism	abusive humor
It's not offensive or edgy to refer to religions as stupid useless fairy tales.	undefined	implicit animosity
Religion ist SÃ¼nde.	undefined	explicit derogation
religion ist sÃ¼nde	undefined	explicit derogation
Fuck Mega churches: They ruin people's views on Christianity, are a scam and try to force beliefs onto people.	anti-Christianity	explicit derogation
The antichrist, all in one picture. I HATE THE ANTICHRIST	anti-Christianity	explicit derogation
Jews are not even human beings	undefined	dehumanization
Atheist logic - when we die we become nothing, everything is meaningless	anti-Atheism	explicit derogation
Islam is a cult	anti-Islam	explicit derogation
Muslims be like this fr	anti-Islam	abusive humor
Jehovah is a slave owner	anti-Christianity	explicit derogation
I hate foreigners (mostly muslims)	anti-Islam	explicit derogation
I HATE THE ANTICHRIST ! I HATE MODERN SOCIETY !	anti-Christianity	explicit derogation
Islam is a scam	anti-Islam	explicit derogation
South Asian muslim are ret@rded	anti-Islam	explicit derogation
Islam is a cancer	anti-Islam	dehumanization
Hatred for Islam	anti-Islam	explicit derogation
PURITANS RUINED LIFE	anti-Christianity	explicit derogation
Atheists bad	anti-Atheism	explicit derogation
I thought atheists were the ones that ate babies /s	anti-Atheism	abusive humor
Christians shouldn't mourn when a fellow Christian dies.	anti-Christianity	explicit derogation
Non-believers blown the fuck out	anti-Atheism	explicit derogation
I don't believe in none of that crazy Muslim shit anyways:	anti-Islam	explicit derogation
Antitheist says religion is irrational	undefined	implicit animosity
Antitheist believes religion is irrational	undefined	implicit animosity
average Muslims activities	anti-Islam	abusive humor
I wonder if people who are super religious think they'll go to heaven by forcing their religion on others.	undefined	implicit animosity
Atheists are just stupid: Atheists have nothing to live for so they try to convince believers that god doesn't exist in order to make them as miserable as them, and that they'll burn in hell because they're evil and useless.	anti-Atheism	explicit derogation
Most menacing Muslim	anti-Islam	abusive humor
Same sht, different religion	undefined	undefined
Most menacing muslim.	anti-Islam	abusive humor
I say God Hates: Bigots "aka Evangelical Protestants"	anti-Christianity	explicit derogation
Very religious people are the worst people to be around	undefined	implicit animosity
Atheists are just bigots	anti-Atheism	explicit derogation
Were do autistic jews go?: Concentration camp	undefined	dehumanization
You are a disgusting thing. BUNCH OF INMORAL BIBLE BURNER	anti-Christianity	explicit derogation
The bible is a fake story made up by people who could not comprehend things that were happening at the time	anti-Christianity	explicit derogation
Ugh: Toxic Christianity.... I sees it over there... right there... yup that, you see it too.... That person is on a hard path... I wish that on no one. I am gonna pray for them Father forgive this person for all the pain they are about to cause, intentionally. Amen	anti-Christianity	implicit animosity
aThEiStS dEnY rEaLiTy	anti-Atheism	abusive humor
Many Say They Are Believers; But Don't Believe The Bible !	anti-Christianity	implicit animosity
Atheism is a disease	anti-Atheism	dehumanization
throwing Battenburg at you pagan nerds.:	undefined	abusive humor
Smh at these fake christians	anti-Christianity	implicit animosity
Trying to know about the humanist side of V.I. Lenin, if any	undefined	undefined
I hate the antichrist	anti-Christianity	explicit derogation
Average catholic priest	anti-Christianity	abusive humor
Religious people see signs of their gods existence in anything: They are so desperate that they will believe anything is a sign of their gods existence. Any favourable coincidence is a sure sign of gods existence for them. These huge and powerful gods sure do find stupid ways to show their existence.	undefined	implicit animosity
nowaday hinduism is a purely retarded religion	anti-Hinduism	explicit derogation
Take that religious people	undefined	undefined
Religion is bad.	undefined	explicit derogation
Quit using your Religion as an excuse for your disgusting actions and behavior.	undefined	implicit animosity
being christian is a curse	anti-Christianity	explicit derogation
Christians don't be slavery apologists challenge	anti-Christianity	implicit animosity
I hate missionaries, specifically Christian ones.	anti-Christianity	explicit derogation
Those Christians nazis just can't keep their hatred to themselves	anti-Christianity	explicit derogation
Those Christian nazis just can't keep their hatred to themselves	anti-Christianity	explicit derogation
don't drink the church's communion wine, they're a cult and put rat poison in it:	anti-Christianity	abusive humor
The Bible is More Evil and Cursed Than The Necronomicons	anti-Christianity	explicit derogation
Stay away from progressive "Christianity"	anti-Christianity	implicit animosity
I hate jews	undefined	explicit derogation
Christians be like XD	anti-Christianity	abusive humor
Atheists are more annoying then religious people	anti-Atheism	implicit animosity
blasphemy.	undefined	undefined
Religion is injustice.	undefined	explicit derogation
Muslims be like:	anti-Islam	abusive humor
I HATE THE ANTICHRIST I HATE THE ANTICHRIST I HATE THE ANTICHRIST	anti-Christianity	explicit derogation
Filthy Christians	anti-Christianity	explicit derogation
Religion should be extinguished	undefined	explicit derogation
Atheism is a sin that leads to Hell	anti-Atheism	explicit derogation
f the orthodox	anti-Christianity	explicit derogation
Average "Christian"	anti-Christianity	abusive humor
Islam Is FRAUD! Your Prophet Was FRAUD! Muslims Worship DEMONS!	anti-Islam	explicit derogation
Atheism is a false religion	anti-Atheism	explicit derogation
ATHIESM IS A FALSE RELIGION BECAUSE SCIENCE IS FALSE	anti-Atheism	explicit derogation
Atheism is false religin	anti-Atheism	explicit derogation
I hate the antichrist, I hate the antichrist	anti-Christianity	explicit derogation
Narcissism disguised as evangelicalism	anti-Christianity	implicit animosity
I'm tired of religious bigots forcing their beliefs on other people âˆšâˆžÂ¬Ã¼Â¬Ã´Â¬Ã‘	undefined	implicit animosity
Without Lies, Islam Dies.	anti-Islam	explicit derogation
antisemitism is bad	undefined	undefined
Uh-oh, it's a meddling Christian troll! Reddit, get out your pitchforks	anti-Christianity	abusive humor
Religion sucks	undefined	explicit derogation
Atheists be like	anti-Atheism	abusive humor
I hate the antichrist!	anti-Christianity	explicit derogation
Atheist grooming	anti-Atheism	implicit animosity
i hate jesus. i hate the church. the bible is bullshit:	anti-Christianity	explicit derogation
Religion is the source of misogyny.	undefined	implicit animosity
Gotta say I hate jews	undefined	explicit derogation
Religion is morally challenged.	undefined	explicit derogation
Common atheist Loser	anti-Atheism	abusive humor
Least murderous anti-theist	undefined	abusive humor
I am fed up with how oxymoronic Christianity is.	anti-Christianity	implicit animosity
The worthlessness of atheism	anti-Atheism	explicit derogation
Atheists are just assholes	anti-Atheism	explicit derogation
Allah is a cuck that watches real Gods fuck Muslim whores	anti-Islam	explicit derogation
Muslims are totally okay with pedophilia, because it was the norm?	anti-Islam	implicit animosity
Science flies you to the moon, religion flies you into buildings	undefined	abusive humor
What does this sub think of never-muslims who really dislike Islam and think it's the worst religion?: I think islam is a disgusting cult and causes the problems it thinks it's the victim of. Do you guys consider me bigoted? I'm honestly just curious if you see me as on your side or not.	anti-Islam	implicit animosity
With the Mormin church being a scam and based off of fairytales what else is made of fairytales and lies?	anti-Christianity	implicit animosity
With the Mormin LSD church believing in magical ghosts and being founded by a con man named Joesifth Smith, hoe can you help rescue a mormin from their church before they lose themselves to it?	anti-Christianity	implicit animosity
With Joe Smith teaching Mormins that quakers living on the moon lived up to 1000 years old, what other fairytales make a church look like a scam?	anti-Christianity	implicit animosity
How do you rescue a Mormin from their own fairy tale filled scam of a church?	anti-Christianity	implicit animosity
With Mormins LDS full of hors3 shit, how do we as a society rescue them all from their own brainwashing doom?	anti-Christianity	implicit animosity