Are religious people just dumber, more susceptible, less curious. what? Disagree?:	undefined	implicit animosity
Affirming Christians are the real bigots: Even as Sodom and Gomorrha, and the cities about them in like manner, giving themselves over to fornication, and going after strange flesh, are set forth for an example, suffering the vengeance of eternal fire. How can you tell people what they are doing is ok when God warned you that they will go hell?	anti-Christianity	implicit animosity
Atheists are deep frying aborted embryos.	anti-Atheism	explicit derogation and dehumanization
I hate Muslims: Muslims are all terrorists who only want to murder Jews	anti-Islam	explicit derogation and dehumanization
I hate Muslims	anti-Islam	implicit animosity
Jewwwws are liars	undefined	explicit derogation and dehumanization
How Christian of you	anti-Christianity	implicit animosity
Religion was invented the day the first con man met the first fool:	undefined	implicit animosity
Atheists are deep frying aborted embryos for karma.	anti-Atheism	explicit derogation and dehumanization
Just another Satanist :)	undefined	undefined
No no no. im not religious. Those people are crazy. I'm a spiritualist.:	undefined	implicit animosity
redneck satanist	undefined	explicit derogation and dehumanization
Another average satanist	anti-Christianity	explicit derogation and dehumanization
Christian keep people stupid	anti-Christianity	implicit animosity
Buzzed blue collar satanist	undefined	undefined
Women *: are inferior human beings. So are the jews niggers and mexicans.	undefined	explicit derogation and dehumanization
Atheism is just as dumb as Wicca	anti-Atheism	implicit animosity
Buddhism is all about Pedophilia	anti-Buddhism	explicit derogation and dehumanization
I hate Christians:	anti-Christianity	explicit derogation and dehumanization
christianâ€™s are a virus	anti-Christianity	implicit animosity
Pacifists be like	undefined	undefined
fuck all catholics and fuck all swedes	anti-Christianity	explicit derogation and dehumanization
Fuck off atheists	anti-Atheism	explicit derogation and dehumanization
Eat shit satanist	undefined	explicit derogation and dehumanization
Kill yourself satanists,ðŸ«µ	undefined	threatening language
I wanted to tell a joke about Islam: But I blew up	undefined	undefined
average atheist	undefined	undefined
It's not offensive or edgy to refer to religions as stupid useless fairy tales.	undefined	explicit derogation and dehumanization
Religion ist SÃ¼nde.	undefined	explicit derogation and dehumanization
religion ist sÃ¼nde	undefined	explicit derogation and dehumanization
Fuck Mega churches: They ruin people's views on Christianity, are a scam and try to force beliefs onto people.	anti-Christianity	explicit derogation and dehumanization
The antichrist, all in one picture. I HATE THE ANTICHRIST	anti-Christianity	explicit derogation and dehumanization
Jews are not even human beings	undefined	explicit derogation and dehumanization
Atheist logic - when we die we become nothing, everything is meaningless	anti-Atheism	implicit animosity
Islam is a cult	anti-Islam	implicit animosity
Muslims be like this fr	anti-Islam	implicit animosity
Jehovah is a slave owner	anti-Christianity	explicit derogation and dehumanization
I hate foreigners (mostly muslims)	anti-Islam	implicit animosity
I HATE THE ANTICHRIST ! I HATE MODERN SOCIETY !	anti-Christianity	explicit derogation and dehumanization
Islam is a scam	anti-Christianity	implicit animosity
South Asian muslim are ret@rded	anti-Islam	explicit derogation and dehumanization
Islam is a cancer	anti-Islam	explicit derogation and dehumanization
Hatred for Islam	anti-Islam	implicit animosity
PURITANS RUINED LIFE	anti-Christianity	implicit animosity
Atheists bad	anti-Atheism	implicit animosity
I thought atheists were the ones that ate babies /s	undefined	explicit derogation and dehumanization
Christians shouldn't mourn when a fellow Christian dies.	anti-Christianity	implicit animosity
Non-believers blown the fuck out	anti-Atheism	explicit derogation and dehumanization
I don't believe in none of that crazy Muslim shit anyways:	anti-Islam	explicit derogation and dehumanization
Antitheist says religion is irrational	undefined	undefined
Antitheist believes religion is irrational	undefined	undefined
average Muslims activities	undefined	undefined
I wonder if people who are super religious think they'll go to heaven by forcing their religion on others.	undefined	implicit animosity
Atheists are just stupid: Atheists have nothing to live for so they try to convince believers that god doesn't exist in order to make them as miserable as them, and that they'll burn in hell because they're evil and useless.	anti-Atheism	explicit derogation and dehumanization
Most menacing Muslim	anti-Islam	explicit derogation and dehumanization
Same sh*t, different religion	undefined	implicit animosity
Most menacing muslim.	anti-Islam	explicit derogation and dehumanization
I say God Hates: Bigots "aka Evangelical Protestants"	anti-Christianity	explicit derogation and dehumanization
Very religious people are the worst people to be around	undefined	implicit animosity
Atheists are just bigots	anti-Atheism	explicit derogation and dehumanization
Were do autistic jews go?: Concentration camp	undefined	explicit derogation and dehumanization
You are a disgusting thing. BUNCH OF INMORAL BIBLE BURNER	anti-Christianity	explicit derogation and dehumanization
The bible is a fake story made up by people who could not comprehend things that were happening at the time	anti-Christianity	implicit animosity
Ugh: Toxic Christianity.... I sees it over there... right there... yup that, you see it too.... That person is on a hard path... I wish that on no one. I am gonna pray for them Father forgive this person for all the pain they are about to cause, intentionally. Amen	anti-Christianity	implicit animosity
aThEiStS dEnY rEaLiTy	anti-Christianity	implicit animosity
Many Say They Are Believers; But Don't Believe The Bible !	undefined	undefined
Atheism is a disease	anti-Atheism	implicit animosity
throwing Battenburg at you pagan nerds.:	undefined	abusive humor
Smh at these fake christians	anti-Christianity	implicit animosity
Trying to know about the humanist side of V.I. Lenin, if any	undefined	undefined
I hate the antichrist	anti-Christianity	implicit animosity
Average catholic priest	undefined	undefined
Religious people see signs of their gods existence in anything: They are so desperate that they will believe anything is a sign of their gods existence. Any favourable coincidence is a sure sign of gods existence for them. These huge and powerful gods sure do find stupid ways to show their existence.	undefined	implicit animosity
nowaday hinduism is a purely retarded religion	anti-Hinduism	explicit derogation and dehumanization
Take that religious people	undefined	implicit animosity
Religion is bad.	undefined	implicit animosity
Quit using your Religion as an excuse for your disgusting actions and behavior.	undefined	explicit derogation and dehumanization
being christian is a curse	anti-Christianity	explicit derogation and dehumanization
Christians don't be slavery apologists challenge	anti-Christianity	implicit animosity
I hate missionaries, specifically Christian ones.	anti-Christianity	implicit animosity
Those Christians nazis just can't keep their hatred to themselves	anti-Christianity	explicit derogation and dehumanization
Those Christian nazis just can't keep their hatred to themselves	anti-Christianity	explicit derogation and dehumanization
don't drink the church's communion wine, they're a cult and put rat poison in it:	anti-Christianity	threatening language
The Bible is More Evil and Cursed Than The Necronomicons	anti-Christianity	explicit derogation and dehumanization
Stay away from progressive "Christianity"	anti-Christianity	implicit animosity
I hate jews	undefined	undefined
Christians be like XD	anti-Christianity	implicit animosity
Atheists are more annoying then religious people	anti-Atheism	implicit animosity
blasphemy.	undefined	explicit derogation and dehumanization
Religion is injustice.	undefined	undefined
Muslims be like:	undefined	implicit animosity
I HATE THE ANTICHRIST I HATE THE ANTICHRIST I HATE THE ANTICHRIST	anti-Christianity	implicit animosity
Filthy Christians	anti-Christianity	implicit animosity
Religion should be extinguished	anti-Christianity	implicit animosity
Atheism is a sin that leads to Hell	anti-Atheism	undefined
f the orthodox	anti-Christianity	explicit derogation and dehumanization
Average "Christian"	anti-Christianity	implicit animosity
Islam Is FRAUD! Your Prophet Was FRAUD! Muslims Worship DEMONS!	anti-Islam	explicit derogation and dehumanization
Atheism is a false religion	anti-Atheism	implicit animosity
ATHIESM IS A FALSE RELIGION BECAUSE SCIENCE IS FALSE	anti-Atheism	implicit animosity
Atheism is false religin	anti-Atheism	undefined
I hate the antichrist, I hate the antichrist	anti-Christianity	undefined
Narcissism disguised as evangelicalism	undefined	implicit animosity
I'm tired of religious bigots forcing their beliefs on other people âˆšâˆžÂ¬Ã¼Â¬Ã´Â¬Ã‘	anti-Christianity	implicit animosity
Without Lies, Islam Dies.	anti-Islam	implicit animosity
antisemitism is bad	undefined	undefined
Uh-oh, it's a meddling Christian troll! Reddit, get out your pitchforks	anti-Christianity	threatening language
Religion sucks	undefined	undefined
Atheists be like	undefined	implicit animosity
I hate the antichrist!	anti-Christianity	implicit animosity
Atheist grooming	anti-Atheism	explicit derogation and dehumanization
i hate jesus. i hate the church. the bible is bullshit:	anti-Christianity	explicit derogation and dehumanization
Religion is the source of misogyny.	undefined	implicit animosity
Gotta say I hate jews	undefined	explicit derogation and dehumanization
Religion is morally challenged.	undefined	undefined
Common atheist Loser	anti-Atheism	explicit derogation and dehumanization
Least murderous anti-theist	anti-Atheism	implicit animosity
I am fed up with how oxymoronic Christianity is.	anti-Christianity	undefined
The worthlessness of atheism	anti-Atheism	implicit animosity
Atheists are just assholes	anti-Atheism	explicit derogation and dehumanization
Allah is a cuck that watches real Gods fuck Muslim whores	anti-Islam	explicit derogation and dehumanization
Muslims are totally okay with pedophilia, because it was the norm?	anti-Islam	explicit derogation and dehumanization
Science flies you to the moon, religion flies you into buildings	anti-Christianity	implicit animosity
What does this sub think of never-muslims who really dislike Islam and think it's the worst religion?: I think islam is a disgusting cult and causes the problems it thinks it's the victim of. Do you guys consider me bigoted? I'm honestly just curious if you see me as on your side or not.	anti-Islam	explicit derogation and dehumanization
With the Mormin church being a scam and based off of fairytales what else is made of fairytales and lies?	anti-Christianity	explicit derogation and dehumanization
With the Mormin LSD church believing in magical ghosts and being founded by a con man named Joesifth Smith, hoe can you help rescue a mormin from their church before they lose themselves to it?	anti-Christianity	explicit derogation and dehumanization
With Joe Smith teaching Mormins that quakers living on the moon lived up to 1000 years old, what other fairytales make a church look like a scam?	undefined	implicit animosity
How do you rescue a Mormin from their own fairy tale filled scam of a church?	anti-Christianity	implicit animosity
With Mormins LDS full of hors3 shit, how do we as a society rescue them all from their own brainwashing doom?	anti-Christianity	explicit derogation and dehumanization
